W W W W W W W W W W W W W W W W W W
W - - - - - - - W W W W - - - - - W
W - P - - - - - - - - - - B - - - W 
W - - - - - W W - - - - W W W - - W 
W - - - B - - - - - - - - W - - - W 
W - - W W W - - - B - W - W - W W W 
W - - W - W - - - - - W - W - W - W 
W - - W - - - - - - - W - W - - - W 
W W - W - - - - - - - - - - - - - W 
W - - - - - W W W - - - - - - - - W 
W W W W W W W W W W W W W W W W W W